RRRRRRRRRRRRRRRRRRRR
R..................R
R..................R
R....D.............R
R...PPP............R
R..................R
R.......D..........R
R......PPP.....D...R
R...........PPPP...R
R..................R
R.PPP..............R
R......D........T..R
R.....PPP......PPP.R
R..................R
R..RRR...FFFFFFFFFFR
R..................R
RRRRRRRPPPPPPPPPPPR
RRRRRRRRRRRRRRRRRRRR